MAP = [
    "+-----------------+",
    "|O|O| : : : : : : |",
    "|O|O| |O| |O| |O| |",
    "|O| : |O| |O| |O| |",
    "| : |O|O| : : : : |",
    "| |O|O|O|O|O| |O| |",
    "| : : : : : : :O: |",
    "| |O|O|O| |O|O|O| |",
    "| |O| : : |O| : : |",
    "| |O| |O|O|O| |O| |",
    "| : : : : : : |O| |",
    "| |O| |O| |O| |O| |",
    "| : : : : : : |O| |",
    "| |O| |O| |O|O|O| |",
    "| : : : : : : : : |",
    "+-----------------+",
]